##################################################
#------##########--------------------------------#
###------------------##############----#####--####
#----###########--#------------------#-----------#
#######---------#----------------------#---###--##
#----------------------#--########--------------##
#######---------#-###-----#---#------------------#
#------------############---------#--------------#
#------------------------######--------########--#
##############--------#-----------#------------###
#--###-#-----###-------------#########----------##
#----------------#------------------- ##------#--#
#-----------------###############----------------#
########--#----------###--#---###-------#--#######
#-------------#--#------------------#------------#
#------------#---------#--#----------------------#
######-----------#----------------##########-----#
#-----------#---#-----#########------------------#
#######----------##-------##########----------####
#-----------#------#-----#---------------#-------#
#---------####-----------------#-----------------$
##################################################  
